                                                                                         #####################                                                                     
    ###############                                                                      #...................#                          ######################                     
    #.............#                                                                      #...................#                          #....................#                     
    #.............#                                                                      #...................#                          #....................#                     
    #.............#                                                                      #...................#                          #....................#                     
    #.............#                                                                      #...................#                          #....................#                     
    #.............#                                                                      #...................#                          #....................#                     
    #.............#                                                                      #...................#                          #....................#    ##############   
    #.............#                     ##########                                       #...................#                          #....................#    #............#   
    #.............#                     #........#                                       #...................#                          #....................#    #............#   
    #.............#                     #........#                                       #...................#                          #....................######............#   
    #.............#                     #........#                     #############     #...................#                          #......................................#   
    #.............#######################........#######################...........#######...................#                          #....................######............#   
    #........................................................................................................#                          #....................#    #............#   
    #.............#######################........#######################...........#####.....................#                          #....................#    #............#   
    #.............#                     #........#                     #...........#   #.....................#                          #....................#    #............#   
    #.............#                   ###........##                    #...........#   #.....................#                          #....................#    ##############   
    #.............#                   #...........#                    #...........#   #.....................#                          ##################.###                     
    #.............###############     #...........#                    #...........#   #.................#####        ####################################.#######                 
    #...........................#     #...........#                    #...........#   #.................#            #..........................................#                 
    #...........................#######...........######################...........#####.................##############.........##########################.#####.###               
    #.................................#............................................................................................................................#               
    ############................#######...........######################...........#####.................##############.........##########################.#####.###               
               #......................#............................................#   #.................##############.........#                        #.#   #.#                 
               #................#######...........######################...........#####........................................##########################.#####.#                 
               #................#######...........#                    #.......................................................................................#.#                 
               #......................#...........#                    #...........####################################.........######################.........#.#                 
               #................#######...........#                    #...........#                                  #.........#                    #.........#.#                 
               #................#     #######.#########################################################################.........######################.........#.#                 
               #................#           #..................................................................................................................#.#                 
               #................#           ###########################################################################.........######################.........#.#                 
               #................#                                                                                     #.........#                    #.........#.#                 
               #................#                                                                                     ###########                    #...........#                 
               #................#                                                                                                                    #...........#                 
               #................#                                                                                                                    #...........#                 
               #................#                                                                                                                    #...........#                 
               #................#                                                                                                                    #...........#                 
               #................#                                                                                                                    #...........#                 
               ##################                                                                                                                    #...........#                 
                                                                                                                                                     #...........#                 
                                                                                                                                                     #.........###                 
                                                                                                                                                     #.........#                   
                                                                                                                                                     #.........#                   
                                                                                                                                                     #.........#                   
                                                                                                                                                     ###########                   
                                                                                                                                                                                   
                                                                                                                                                                                   
                                                                                                                                                                                   

                                                                                                                                                                                   