...........###############..........................................................................................................................................................
...........#.............#..........................................................................................................................................................
...........#.............#..........................................................................................................................................................
...........#.............#..........................................................................................................................................................
...........#.............#..........................................................................................................................................................
...........#.............#..........................................................................................................................................................
...........#.............#..........................................................................................................................................................
...........#.............#..........................................................................................................................................................
...........#.............#..........................................................................................................................................................
...........#.............#..........................................................................................................................................................
...........#.............#..........................................................................................................................................................
...........#.............#..........................................................................................................................................................
...........#.............#..........................................................................................................................................................
...........#.............#..........................................................................................................................................................
...........#####.#########..........................................................................................................................................................
...............#.#....................#######.......................................................................................................................................
...............#.#....................#.....#.......................................................................................................................................
...............#.#....................#.....#.......................................................................................................................................
...............#.#....................#.....#.......................................................................................................................................
...............#.#....................#.....#.......................................................................................................................................
...............#.#....................#.....#.......................................................................................................................................
...............#.######################.....#.......................................................................................................................................
...............#............................#.......................................................................................................................................
...............#.######################.....#.......................................................................................................................................
...............#............................#.......................................................................................................................................
...............#.######################.....#.......................................................................................................................................
...............#.#....................#.....#.......................................................................................................................................
...............#.#....................###.###.......................................................................................................................................
...............#.#......................#.#.........................................................................................................................................
...............#.#......................#.#..............................................................................................................................#########..
...............#.#......................#.#..............................................................................................................................#.......#..
...##########..#.#......................#.#...................................................................................................##############.............#.......#..
...#........#..#.#......................#.#...................................................................................................#............#.............#.......#..
...#........#..#.#......................#.#................................####################################################################............###############.......#..
...#........#..#.#......................#.#................................#.....................................................................................................#..
...#........#..#.#......................#.#................................#.............############.......###################################............###############.......#..
...#........####.########################.##################################.............############.......###################################............###############.......#..
...#........#....................................................................................................................................................................#..
...#.......................................................................................................................................................###############.......#..
...#........#............###################################################.............############.......###################################............###############.......#..
...#........#............#.................................................#.............#..........#............................................................................#..
...#........#............#.................................................#.............#..........#.......###################################............#######################..
...#........#............#.................................................#.............#..........#.......###################################............#........................
...#........#............#.................................................#.............#..........#......................................................#........................
...#........#............#.................................................#.............#..........#.......###################################............#........................
...##########............#.................................................#.............#..........#.......#.................................#............#........................
............#............#.................................................#.............#..........#.......#.................................#............#........................
............##############.................................................#.............#..........#########.................................##############........................
...........................................................................#.............#..........................................................................................
...........................................................................###############..........................................................................................
