................................................................########################################################################################################............
................................................................#......................................................................................................#............
................................................................#.#######################################################################################..............#............
................................................................#.#.....................................................................................#..............#............
................................................................#.#.......###############################################################################..............#............
................................................................#.#.......#............................................................................................###..........
..............................................................###.#########.#############################................................................................#..........
..............................................................#...........#.#############################............####################################..............#.#..........
..............................................................#.........................................#............#..................................#..............#.#..........
..............................................................#...........#.###########################.#............#..................................#..............#.#..........
..............................................................#...........#.#.........................#.#######.######..................................#..............#.#..........
..............................................................#...........#.#.........................#.#.....#.#.......................................#..............#.#..........
..............................................................###..##.#####.#.........................#.#.....#.#.......................................#..............#.#..........
............................................................#####..##.#####.#.........................#.#.....#.#.......................................############.###.#..........
............................................................#...............#.........................#.#.....#.#..................................................#.#.#.#..........
............................................................#...............#.........................#.#.....#.#..................................................#.###.##.........
............................................................#...............#.........................#.#.....#.#..................................................#......#.........
............................................................#...............#.........................#.#.....#.#..................................................#......#.........
............................................................#...............#.........................#.#.....#.#..................................................#......#.........
............................................................#...............#.........................#.#.....#.#..................................................#......#.........
............................................................#...............###########################.#######.####################################################......#.........
............................................................#.............................................................................................................#.........
............................................................#...............###########################.#######.####################################################......#.........
............................................................#.................................................................................................#....#......#.........
............................................................#####.###.#################################.#######.#############################################.#....#.######.........
................................................................#.#.#.#...............................#.#.....#.#...........................................#.#....#.#..............
................................................................#.#.#.#...............................#.#######.#...........................................#.#....#.#..............
................................................................#.#.#.#...............................#......##.#...........................................#.#....#.#..............
................................................................#.#.#.#...............................#......##.#############################################.######.#####..........
..............................................................###.###.#...............................#......##..........................................................#..........
..............................................................#.....#.#...............................#......################################################............#..........
..............................................................#.....#.#################################......################################################............#..........
..............................................................#..........................................................................................................#..........
..............................................................#.....#.#################################......################################################............#..........
..............................................................#.....#.#...............................#......#..............................................#............#..........
..............................................................#.....#.#...............................#......#..............................................#............#..........
..............................................................#.....#.#...............................#......#..............................................#............#..........
..............................................................#.....#.#...............................########..............................................#............#..........
..............................................................#.....#.#.....................................................................................#............#..........
..............................................................#.....#.#.....................................................................................#............#..........
..............................................................#.....#.#.....................................................................................#............#..........
..............................................................#.....#.#######################################################################################............#..........
..............................................................#######....................................................................................................#..........
....................................................................######################################################################################################..........
....................................................................................................................................................................................
....................................................................................................................................................................................
....................................................................................................................................................................................
....................................................................................................................................................................................
....................................................................................................................................................................................
....................................................................................................................................................................................
