....................................................................................................................................................................................
....................................................................................................................................................................................
....................................................................................................................................................................................
....................................................................................................................................................................................
....................................................................................................................................................................................
....................................................................................................................................................................................
....................................................................................................................................................................................
.................################...................................................................................................................................................
.................#..............#...................................................................................................................................................
.................#..............#..........#######..............................................................................................................#############.......
.................#..............#..........#.....#..............................................................................................................#...........#.......
.................#..............#..........#.....################################...............................................................................#...........#.......
.................#..............#..........#.....#..............................#...............................................................................#...........#.......
.................#..............#..........#.....#.....########################.#...............................................................................#...........#.......
.................#########.##.###..........#.....#.....#......................#.#...............................................................................#...........#.......
.........................#.##.#............#.....#.....#......................#.#...............................................................................#...........#.......
.........................#.##.#............#.....#.....#......................#.#...............................................................................#...........#.......
.........................#.##.#............#.....#.....#......................#.#...............................................................................#...........#.......
.........................#.##.##############.....#.....########################.#################...............................................................#...........#.......
.........................#.##...................................................................#...............................................................#.###########.......
.........................#.#################............................#######.###.............#...............................................................#.#.................
.........................#......................................................................#...............................................................#.#.................
.........................#####################.###.....##...............#######.###.............#...............................................................#.#.................
.............................................#.#.#####.##...............#.....#.#.#.............#...............................................................#.#.................
.............................................#.#.....#.##...............#.....#.#.#.............#...............................................................#.#.................
.............................................#.#.....#.##...............#.....#.#.#.............#...............................................................#.#.................
.............................................#.#.....#.##...............#.....#.#.#.............#...............................................................#.#.................
.............................................#.#.....#.##...............#.....#.#.#.............#...............................................................#.#.................
.............................................#.#.....#.##...............#.....#.#.#.............#...............................................................#.#.................
.............................................#.#.....#.##...............#.....#.#.###############...............................................................#.#.................
.............................................#.#.....#.##################.....#.#...............................................................................#.#.................
.............................................#.#.....#.#......................#.#...............................................................................#.#.................
.............................................#.#.....#.#......................#.#...............................................................................#.#.................
.............................................#.#.....#.#.###########..........#.#...............................................................................#.#.................
.............................................#.#.....#.#.#.........#..........#.#...............................................................................#.#.................
.............................................#.#.....#.#.#.........#..#########.##..............................................................................#.#.................
.............................................#.#.....#.#.#.........#..#..........#..............................................................................#.#.................
.............................................#.#.....#.###.........#..#..........################################################################################.#.................
.............................................#.#.....#.............#..#...........................................................................................#.................
.............................................#.#.....#####.........#..#..........##################################################################################.................
.............................................#.#.........#.........#..#..........#..................................................................................................
.............................................#.#.........#.........#..#..........#..................................................................................................
.............................................#.#.........#.........#..#..........#..................................................................................................
.............................................#.#.........#.........#..#..........#..................................................................................................
.............................................#.#.........#.........#..#..........#..................................................................................................
.............................................#.#.........#.........#..############..................................................................................................
.............................................#.###########.........#................................................................................................................
.............................................#.....................#................................................................................................................
.............................................#############.........#................................................................................................................
.........................................................###########................................................................................................................
