                                                                                                                                                                                    
                                                                                                                                                                                    
                                                                                                                                                                                    
                                                                                                              #######                                                               
         ######################################################################################################.....#                                                               
         #..........................................................................................................#########                                                       
         #.##############################################...........###########################################.............#                                                       
         #.#                                            #...........#                                         #.....#######.#                                                       
         #.#                                            #...........#                                         #.....#     #.#            ########                                   
         #.#                                            #...........#                                         #######     #.#            #......#                                   
         #.#                                            #...........#                                                     #.#            #......#                                   
         #.#                                            #...........#                                                     #.#            #......#                                   
         #.#                                            #...........#######################################################.##############......#                                   
         #.#                                            #.......................................................................................#                                   
         #.#                                            ###################################################################.##############......#                                   
         #.#                                                                                                              #.#            #......#                                   
##########.#                                                                                                            ###.##########   #......#                                   
#.......##.#                                                                                                            #............#   #......#                                   
#.......##.#                                                                                                            #............#   #......#                                   
#.......##.##############################################################################################################............#####......#                                   
#...............................................................................................................................................#                                   
#.......##.##################################################################################.###########################............#####......#                                   
#.......##.#                                                                                #.#                         #............#   ########                                   
#.......##.#                                                                                #.#                         #............#                                              
#.......##.#                                                                                #.#                         #............#                                              
#.......##.#                                                                                #.#                         #............#                                              
#.......##.#                                                                                #.#                         #............#                                              
#.......##.#                                                                           ######.###########################............#                                              
#######.##.#                                                                           #.............................................#                                              
      #.##.#                                                                           #.......#######################################                                              
      #.##.#                                                                           #.......#                                                                                    
      #.##.#                                                                           #.......#                                                                                    
      #.##.#                                                                           #.......#                                                                                    
      #.##.#                                                            ################.......#                                                                                    
      #.##.#                                                            #.............##.......#                                                                                    
      #.##.#                                                            #.............##.......#                                                                                    
      #.##.#                                                            #.............##########                                                                                    
      #.##.#                                                            #.............#                                                                                             
      #.##.##############################################################.............#                                                                                             
      #.##............................................................................#                                                                                             
     ##.##..#############################################################.............#                                                                                             
     #...........#                                                      ###############                                                                                             
     #...........#                                                                                                                                                                  
     #...........#                                                                                                                                                                  
     #...........#                                                                                                                                                                  
     #...........#                                                                                                                                                                  
     #...........#                                                                                                                                                                  
     #...........#                                                                                                                                                                  
     #...........#                                                                                                                                                                  
     #############                                                                                                                                                                  
