....................................................................................................................................................................................
....................................................................................................................................................................................
....................................................................................................................................................................................
...............................................................................................................................................#############........................
.....................................................................................................###############.......##########..........#...........#........................
.....................................................#################################################.............#########........#..........#...........#........................
.....................................................#..............................................................................#..........#...........#........................
.....................................................#.###############################################.............#########........#..........#...........#........................
.....................................................#.#.............................................#.............#.......#........#..........#...........#........................
.....................................................#.#......................................########.............#########........#..........#...........#........................
.....................................................#.#......................................#.....................................#..........#...........#........................
.....................................................#.#......................................#.#################.##########........#..........#...........#........................
.....................................................#.#......................................#.#....#.........##.#........#........#..........#...........#........................
.....................................................#.#......................................#.#....#.........##.#........##########..........#...........#........................
.....................................................#.#......................................#.#....#.........##.##############################...........#........................
.....................................................#.#......................................#.#....#.....................................................#........................
.....................................................#.#................................#######.######.........##.####.....#################################........................
................................................######.##################################......................##.#..#.....#........................................................
................................................#.................................................................#..#.....#........................................................
................................................#..............##########################.#####.###################..#.....#........................................................
................................................#..............#........................#.#...#.#....................#.....#........................................................
................................................#..............#........................#.#...#.#....................#.....#........................................................
................................................#..............#........................#.#...#.#....................#.....#........................................................
................................................#..............#........................#.#...#.#....................#.....#........................................................
................................................#..............#........................#.#...#.#....................#.....#........................................................
................................................#..............#........................#.#...#.#....................#.....#........................................................
................................................#..............#........................#.#...#.#....................#.....#........................................................
................................................#..............#........................#.#...#.#....................#.....#........................................................
................................................#..............#........................#.#...#.#....................#####.#........................................................
................................................#..............#........................#.#...#.#........................#.#........................................................
................................................##############.#......................###.#####.#........................#.#........................................................
.............................................................#.#......................#.........#........................#.#........................................................
.............................................................#.#......................#.........#........................#.#........................................................
.............................................................#.#......................#.........#........................#.#........................................................
.............................................................#.#......................#.........#........................#.#........................................................
.............................................................#.#......................#.........#........................#.#........................................................
.............................................................#.#......................#.........#........................#.#........................................................
.............................................................#.#......................###########........................#.#........................................................
.............................................................#.#.........................................................#.#........................................................
.............................................................#.#.........................................................#.#........................................................
.............................................................#.#..........##########.....................................#.#........................................................
.............................................................#.#..........#........#.....................................#.#........................................................
.............................................................#.############........#.....................................#.#........................................................
.............................................................#.....................#.....................................#.#........................................................
.............................................................##############........#######################################.#........................................................
..........................................................................#................................................#........................................................
..........................................................................##################################################........................................................
....................................................................................................................................................................................
....................................................................................................................................................................................
....................................................................................................................................................................................
