....................................................................................................................................................................................
....................................................................................................................................................................................
....................................................................................................................................................................................
....................................................................................................................................................................................
....................................................................................................................................................................................
....................................................................................................................................................................................
....................................................................................................................................................................................
....................................................................................................................................................................................
........................................................................................####################################################################################........
..########..............................................................................#..................................................................................#........
..#......##############################################################.................#...........######################################################################.#........
..#...................................................................#.................#...........#....................................................................#.#........
..#......###############################.############################.#.................#...........#....................................................................#.#........
..#......#.............................#.#..........................#.#.................#...........#....................................................................#.#........
..#......#.............................#.#..........................#.#.................#...........#....................................................................#.#........
..########........................######.##.........................#.#.................#...........#....................................................................#.#........
..................................#.......#.........................#.#.................#...........#....................................................................#.#........
..................................#.......#.........................#.#.................#...........#....................................................................#.#........
..................................#.......#.........................#.#.................#...........#....................................................................#.#........
..................................#.......#.......................###.######............#...........#....................................................................#.#........
..................................#.......#.......................#........#............#...........#....................................................................#.#........
..................................#.......#.......................#........#............#...........#....................................................................#.#........
..................................#.......#.......................#........#............#...........#....................................................................#.#........
..................................#.......#.......................#........#............#...........#....................................................................#.#........
..................................#.......#.......................#........#################.......##....................................................................#.#........
..................................#.......#.......................#................................#.....................................................................#.#........
..................................#.......#.......................#........#################.......#.....................................................................#.#........
..................................#########.......................##########...............#.......#.....................................................................#.#........
...........................................................................................#.......#.....................................................................#.#........
...........................................................................................#.......#######################################################################.##.......
...........................................................................................#................................................................................#.......
...........................................................................................#.......#######################################################################..#.......
...........................................................................................#######.################......................................................#..#.......
.................................................................................................#................#......................................................#..#.......
.................................................................................................#########........#......................................................#..#.......
.........................................................................................................#........#................................................#######..#######.
...........................................###############################################################........#................................................#..............#.
...........................................#......................................................................#................................................#..............#.
........................................####.######################################################################................................................#..............#.
........................................#............###############################################################################################################..............#.
........................................#.........................................................................................................................................#.
........................................#............###############################################################################################################..............#.
........................................#............#.............................................................................................................################.
........................................#............#..............................................................................................................................
........................................#............#..............................................................................................................................
........................................#............#..............................................................................................................................
........................................##############..............................................................................................................................
....................................................................................................................................................................................
....................................................................................................................................................................................
....................................................................................................................................................................................
