....................................................................................................................................................................................
...............................................................................................................................................................###################..
...............................................................................................................................................................#.................#..
.........##########################............................................................................................................................#.................#..
.........#........................#............................................................................................................................#.................#..
.........#........................#............................................................................................................................#.................#..
.........#........................##########...................................................................................................................#.................#..
.........#........................#........#...................................................................................................................#.................#..
.........#........................#........#...................................................................................................................#.................#..
.........#........................#........#...................................................................................................................#.................#..
.........#........................#........#...................................................................................................................#.................#..
.........#........................#........#...................................................................................................................#.................#..
.........#........................#........#...................................................................................................................#.................#..
.........#........................#........#######.............................................................................................................#.................#..
.........#........................#..............#.............................................................................................................#.................#..
.........#........................#........#####.#.............................................................................................................#.................#..
.........#........................#........#...#.#.............................................................................................................#.................#..
.........#........................##.#######...#.#.............................................................................................................#.................#..
.........#........................##.###########.#######################.......................................................................................#.................#..
.........#.............................................................#.......................................................................................#.................#..
.........#........................##.###########.#####################.#.......................................................................................#.................#..
.........#........................##.#.........#.#...................#.#.......................................................................................#.................#..
.........#........................##.#.........#.#...................#.#...................................................................#####################.................#..
.........#........................##.#.........#.#...................#.#...................................................................#.....................................#..
.........#........................##.#.........#.#...................#.#...................................................................#.###################.................#..
.........#........................##.#.........#.#...................#.#...................................................................#.#.................#.................#..
.........#........................##.#.........#.#...................#.#...................................................................#.#.................################.##..
.........###############.#####.#####.#.........#.#...................#.#...........................##################................#######.#############....................#.#...
.......................#.#...#.#...#.#......####.###########........##.###############.............#................#................#...................#....................#.#...
.......................#.#...#.#...#.#......#..............#........#................#.............#................#................#...................#....................#.#...
.......................#.#####.#####.########..............##########................###############................##################...................######################.#...
.......................#........................................................................................................................................................#...
.......................#...................................##########................###############.....................................................########################...
.......................#...................................##########................###############................##################...................#..........................
.......................#............................................................................................#................#...................#..........................
.......................#.....................########################................###############................#................#...................#..........................
.......................#############.################################................#.............#................#................#...................#..........................
...................................#.................................................#.............#................#................#...................#..........................
...................................##################################................#.............##################................#...................#..........................
....................................................................#................#...............................................#...................#..........................
....................................................................#................#...............................................#...................#..........................
....................................................................#................#...............................................#...................#..........................
....................................................................#................#...............................................#####################..........................
....................................................................##################..............................................................................................
....................................................................................................................................................................................
....................................................................................................................................................................................
....................................................................................................................................................................................
....................................................................................................................................................................................
....................................................................................................................................................................................
....................................................................................................................................................................................
