....................................................................................................................................................................................
....................................................................................................................................................................................
....................................................................................................................................................................................
...........................................................................................................................................................#################........
...........................................................................................................................................................#...............#........
...........................................................................................................................................................#...............#........
..................................................................................................################.........................................#...............#........
..................................................................................................#..............#.........................................#...............#........
..................................................................................................#..............#.........................................#...............#........
..................................................................................................#..............#.........................................#...............#........
..................................................................................................#..............#.........................................#...............#........
..................................................................................................#..............#.........................................#...............#........
..................................................................................................#..............#.........................................#...............#........
..................................................................................................#..............#.........................................#...............#........
..................................................................................................#..............#.........................................#...............#........
..................................................................................................#..............#.........................................#...............#........
...........###################....................................................................#..............#.........................................#...............#........
...........#.................#....................................................................#..............#.........................................#...............#........
...........#.................#....................................................................#..............#.........................................#...............#........
...........#.................#................................#####################################..............#.........................................#...............#........
...........#.................#................................#..................................................#.........................................#...............#........
...........#.................#................................#.............#...................###..............#.........................................#...............#........
...........#.................#................................#.............#...................#.#..............#.........................................#...............#........
...........#.................#................................#.............#...................#.#..............#..............................############...............#........
...........#.................#................................#.............#...................#.#..............#..............................#..........................#........
...........#.................#................................#.............#...................#.#..............#..............................#.##########...............#........
...........#.................#................................#.............#...................#.#..............#..............................#.#........#...............#........
...........#.................#................................#.............#...................#.#..............#..............................#.#........#############.###........
...........#.................#................................#.............#...................#.#..............################################.#####................#.#..........
...........#.................#................................#.............#...................#.##########..........................................#................#.#..........
...........#.................#................................#.............#...................#..........###################################........#................#.#..........
...........#.................#................................#.............#...................##################...........#...............#........#................#.#..........
...........#.................#................................#.............#................................................#...............#........#................#.#..........
...........#.................#................................#.............#...................##################...........#...............#........#..........#######.########...
...........#.................##################################.............#...................##################...........#################........############..............#...
...........#....................................................................................................................................................................#...
...........#.................................................................................................................#################........############..............#...
...........####################################################.............#...................##################...........#...............##########..........#..............#...
..............................................................#.............#...................#................#...........#...................................#..............#...
..............................................................#.............#...................#................#...........#...................................#..............#...
..............................................................#.............#...................#................#...........#...................................#..............#...
..............................................................#.............#...................#................#...........#...................................#..............#...
..............................................................#.............#...................#................#...........#...................................################...
..............................................................#.............#####################................#...........#......................................................
..............................................................###############....................................#############......................................................
....................................................................................................................................................................................
....................................................................................................................................................................................
....................................................................................................................................................................................
....................................................................................................................................................................................
....................................................................................................................................................................................
