....................................................................................................................................................................................
....................................................................................................................................................................................
..........................................................................................#######...................................................................................
............................................###############...............................#.....#...................................................................................
............................................#.............#...............................#.....#...................................................................................
............................................#.............#...............................#.....#...................................................................................
............................................#.............#...............................#.....#.........................................###############...........................
............................................#.............#...............................#.....#.........................................#.............#.......#############.......
............................................#.............#...............................#.....#.........................................#.............#.......#...........#.......
............................................#.............#...............................#.....#....###############......................#.............#.......#...........#.......
............................................#.............#...............................#.....#....#.............#......................#.............#.......#...........#.......
...........############.....................###############...............................#######....#.............#......................#.............#.......#...........#.......
...........#..........#..............................................................................#.............#......................#.............#.......#...........#.......
...........#..........#..............................................................................#.............#......................#.............#.......#...........#.......
...........#..........#..............................................................................#.............#......................#.............#.......#...........#.......
...........#..........#..............................................................................#.............#......................#.............#.......#...........#.......
...........#..........#..............................................................................#.............#......................#.............#.......#...........#.......
...........#..........#..............................................................................#.............#......................#.............#.......#...........#.......
...........#..........#..............................................................................#.............#......................#.............#.......#...........#.......
...........#..........#..............................................................................#.............#......................#.............#.......#...........#.......
...........#..........#..............................................................................#.............#......................#.............#.......#...........#.......
...........#..........#..............................................................................#.............#......................###############.......#...........#.......
...........#..........#..............................................................................###############............................................#...........#.......
...........#..........#.........................................................................................................................................#############.......
...........#..........#.............................................................................................................................................................
...........############.......................................................................................................................................#################.....
..............................................................................................................................................................#...............#.....
..............................................................................................................................................................#...............#.....
..............................................................................................................................................................#...............#.....
..............................................................................................................................................................#...............#.....
..............................................................................................................................................................#...............#.....
..........................................................................................................................................#################...#...............#.....
..........................................................................................................................................#...............#...#...............#.....
..........................................................................................................................................#...............#...#...............#.....
..........................................................................................................................................#...............#...#...............#.....
........###############........................................#############..............................................................#...............#...#...............#.....
........#.............#........................................#...........#..............................................................#...............#...#...............#.....
........#.............#........................................#...........#..............................................................#...............#...#...............#.....
........#.............#........................................#...........#..............................................................#...............#...#...............#.....
........#.............#........................................#...........#..............................................................#...............#...#...............#.....
........#.............#........................................#...........#..............................................................#################...#################.....
........#.............#........................................#...........#........................................................................................................
........#.............#........................................#...........#........................................................................................................
........#.............#........................................#...........#........................................................................................................
........#.............#........................................#...........#........................................................................................................
........#.............#........................................#############........................................................................................................
........#.............#.............................................................................................................................................................
........###############.............................................................................................................................................................
....................................................................................................................................................................................
....................................................................................................................................................................................
