                                                                                                                                                                                    
                                                                                             #############                                                                          
                                                                                             #...........#                                                                          
                                                                                             #...........#                                                                          
                                                                                             #...........#                                                                          
                                                                                             #...........#                                                                          
                                                                                             #...........#                                                                          
                                                                  ########                   #...........#                                                                          
                                                                  #......#                   #...........#                                                                          
                                                                  #......#                   #...........#                                                                          
                                                                  #......#                   #...........###################################################                        
                                                                  #......#                   #.............................................................#                        
                                                                  #......#                   #...........#################################################.#                        
                                                                  ##.#####                   #...........#                                               #.#                        
                                                                   #.#                       #...........#                                               #.#                        
                                                                   #.#                       #...........#                                               #.#                        
                                                                   #.#                       ###.#########                                               #.#                        
                                                                   #.#                         #.#                                                       #.#                        
                                                                   #.#                         #.#              ##########                               #.#                        
                                                                   #.#                         #.#              #........#################################.#############            
                                                                   #.#                         #.#              #......................................................#            
                                        #######       ##########   #.#                         #.#              #........#################################.###########.#            
                                        #.....#       #........#   #.#                         #.################........#                               #.#         #.##########   
                                        #.....#       #........#####.###########################.........................#################################.###########..........#   
                                        #.....#       #.........................................................................................................................#   
                                        #.....#       #........#####.#####################################################################################.###########..........#   
                                        #.....#       #..............#                                                                                   #.#         #..........#   
                                        #.....#       #........#######                                                                              ######.###       #..........#   
                                        #.....#       #........#                                                                                    #........#       #..........#   
                                        #.....#       #........#                                                                                    #........#       #..........#   
                                        #.....#########........######################################################################################........#########..........#   
                                        #.......................................................................................................................................#   
                                        #....................................................................................................................#########.##########   
                                        #.....#########........######################################################################################........#########.....#        
                                        #..................................................................................................................................#        
                                        ###############........######################################################################################........#########.....#        
                                                      #........#                                                                                    #........#       #.....#        
                                                      ##########                                                                                    #........#       #.....#        
                                                                                                                                                    #........#       #.....#        
                                                                                                                                                    #........#       #.....#        
                                                                                                                                                    ##########       #.....#        
                                                                                                                                                                     #.....#        
                                                                                                                                                                     #.....#        
                                                                                                                                                                     #.....#        
                                                                                                                                                                     #.....#        
                                                                                                                                                                     #.....#        
                                                                                                                                                                     #######        
                                                                                                                                                                                    
                                                                                                                                                                                    
                                                                                                                                                                                    
