                                                                                                                                                                                    
                                                                                                                                                                                    
                                                                                                                                                                                    
                                                                                                                                                                                    
                                                                                                                                                                                    
                                                                                                                                                                                    
                                                                                                                                                                                    
                                                                                                                                                                                    
                                                                                                                                                                                    
                                                                                                                                                                                    
                                                                                                                                                                                    
                                                                             ################                                                                                       
 ##########                                                                  #..............#                                                                                       
 #........#                                                                  #..............#                                                                                       
 #........####################################################################..............###############                                                                         
 #........................................................................................................#                                                                         
 #........####################################################################..............#############.#                                                                         
 #........#                                                                  #..............#           #.#                                                                         
 #........#                                                                  #..............#           #.#                  #######                                                
 ##.#######                                                                  #..............#############.####################.....#                                                
  #.#                                                                        #.....................................................#                                                
  #.#                                                                        #..............#############.####################.....#                                                
  #.#                                                                        #..............#############.####################.....#                                                
  #.#                                                                        #.....................................................#                                                
  #.#                                                                        #..............#############.####################.....#                                                
  #.#                                                                        #..............#           #.#                  #.....#                                                
  #.#                                                                        #..............#           #.#                  #.....#                                                
  #.#                                                                        ################           #.#                  #.....#                                                
  #.#                                                                                                   #.#                  ##..###                                                
  #.#                                                                                             #######.##                  #..#                                                  
###.###############################################################################################........#                  #..#                                                  
#..........................................................................................................#                  #..#                                                  
#...............###################################################################################........#                  #..#                                                  
#...............#                                                                                 #........#                  #..#                                                  
#...............###################################################################################........####################..#                                                  
#................................................................................................................................#                                ############      
#...............###################################################################################........####################..#                                #..........#      
#...............#                                                                                 #........####################..#####                            #..........#      
#...............#                                                                                 #..................................#                            #..........#      
#...............#                                                                                 #........####################......#                            #..........#      
#...............#                                                                                 #........#                  #......#                            #..........###    
#...............#                                                                                 #........#                  #......#                            ##...........#    
#...............###################################################################################........####################......###############################...........#    
#..............................................................................................................................................................................#    
###############################################################################################################################......###############################...........#    
                                                                                                                              #......###############################...........#    
                                                                                                                              #................................................#    
                                                                                                                              ##################################################    
                                                                                                                                                                                    
                                                                                                                                                                                    
