                                                                                                                                                                                    
                                                                                                                                                                                    
                                                                                                                                                                                    
                                                                                                                                                                                    
                                                                                                                                                                                    
                                                                                                                                                                                    
                                                                                                                   ############                                                     
                                                                                                                   #..........#                                                     
                                                                                                                   #..........#                                                     
                                                                                                                   #..........#                                                     
                                                                                                                   #..........#                                                     
                                                                                                                   #..........#                                                     
                                                                                                                   #..........#                                                     
                ####################################################################################################..........####################                                  
                #................................................................................................................................#                                  
                #.##################################################################################################..........##############.....################                   
                #.#                                                          #######################################............................................#                   
                #.#                                                          #...................................................................##############.#                   
                #.#                                                          #.#####################################..........##############.....#            #.#           ####### 
                #.#                                                          #.#                                   #..........#            #.....#            #.#           #.....# 
                #.#                                                          #.#                                   ############            #.....#            #.#           #.....# 
                #.#                                                          #.#                                                           #######            #.#           #.....# 
                #.#                                                          #.#                                                                              #.#           #.....# 
              ###.########                                                   #.#                                                                              #.#           #.....# 
              #..........#                                                   #.#                                                                              #.#           #.....# 
###############..........#                                                   #.#                                                                              #.#           #.....# 
#........................#                                                   #.#                                                                              #.#           #.....# 
#........................#                                            ########.###                                                                            #.#           #.....# 
#........................##############################################..........#                                                                     ########.#####       #.....# 
#................................................................................#                                                                     #............#########.....# 
#...............#######################################################..........#######################################################################..........................# 
#...................................................................................................................................................................#########.....# 
###############...................................................................................................................................................................# 
              #.#######################################################..........#######################################################################............#########.....# 
              #.#                                                     #..........#                                                                     #............#       ####### 
              #.#                                                     ############                                                                     #............#               
              #.#                                                                                                                                      ##############               
              #.#                                                                                                                                                                   
              #.#                                                                                                                                                                   
              #.#                                                                                                                                              ##############       
              #.#                                                                                                                                              #............#       
              #.#                                                                                                                                              #............#       
              #.################################################################################################################################################............#       
              #.............................................................................................................................................................#       
              ##################################################################################################################################################............#       
                                                                                                                                                               #............#       
                                                                                                                                                               ##############       
                                                                                                                                                                                    
                                                                                                                                                                                    
                                                                                                                                                                                    
