                                                                                                                                                                                    
                                                                                                                                                                                    
                                                                                                                                                                                    
                                                                                                                                                                                    
                                                                                                                                                                                    
                                                                                                                                                                                    
                                                                                                                                                                                    
                                                                                                                                                                                    
                                                                     ###############                                                                                                
                                                                     #.............#                                                                                                
                                                                     #.............#                                                                                                
                                                                     #.............#                                                                                                
                                                                     #.............#                                                                                                
                                                ######################.............#                                                                                                
                                                #..................................#                                                                                                
                                                #.####################.............#                                                                                                
                                                #.#                  #.............#                                                                                                
                                                #.#                  ###############                                                                                                
                                                #.#                         #############                                                                                           
                                                #.#                         #...........#                                                                                           
                                                #.#                         #...........#                                                                                           
                                                #.#      ####################...........#                                                                                           
                                                #.#      #..............................#                                                                ############               
                                                #.#      #.##################...........#                                                                #..........#               
                                                #.#      #.#                #########.###                                                                #..........#               
                                                #.#   ####.######                   #.#                                                                  #..........#               
                                                #.#   #.........#                   #.#                                                                  #..........#               
                                                #.#   #.........#                   #.#                                                                  #..........#               
                                                #.#   #.........#                   #.#                                                                  #..........#               
                                              ###.### #.........#                   #.#                                                                  #..........#               
                                              #.....# #.........#                   #.#                    ########                                      #..........#               
                                              #.....# #.........#                ####.#########            #......#                                      #..........#               
                                              #.....# #.........#                #............#            #......#                                      #..........#               
                                              #.....###.........##################............##############......########################################..........#               
                                              #.....................................................................................................................#               
                                              #.....###.........##################............##############......########################################..........#               
                                              #.....# #.........#                #............#            #......#                                      #########..#               
                                              #.....# #.........#                ##############            #......#                                              #..#               
                                              #.....# #.........#                                          #......#                                              #..#               
                                              #.....# #.........#                                          #......#                                              #..#               
                                              ####### ###########                                          #......#                                              #..###########     
                                                                                                           #......################################################............#     
                                                                                                           #..................................................................#     
                                                                                                           #######################################################............#     
                                                                                                                                                                 #............#     
                                                                                                                                                                 #............#     
                                                                                                                                                                 #............#     
                                                                                                                                                                 ##############     
                                                                                                                                                                                    
                                                                                                                                                                                    
